                                                                                                      
                                                                                                      
                                                                                                      
                   ┌──────┐                                                ┌───┐                      
                   ┃......│                                   ┌───┐┌────┐  ┃...│             ┌────┐   
      ┌──────┐     ┃......│             ┌───┐          ┌─────┐┃...│┃....│  ┃...┟───────┐     ┃....│   
      ┃......┟───┐ ┃......│             ┃...│          ┃.....┗┛...│┃....│  ┃...╵.......│     ┃....│   
      ┃......║...│ ┃......│       ┌─────┛...┟────────┐ ┃..........│┃....│ ┌┛...........│     ┃....│   
      ┃......╵...┗─┛......┗──────┐┃.........║........│┌┛.....╶╴...│┃....┗─┛..╳.╳.......┗───┐ ┃....│   
      ┃..........................│┃.........╵........│┃..........┏┘┃..............┏┓.......│┌┛..┏━┘   
      ┃..................╷.......┗┛..................│┃..........│┌┛....┏━┓.......│└┓......┟┛..┏┘     
      ┃......╷.....^.....┞┓.................╷........│┃..........┗┛.....│ ┃.......│ ┃......╵..┏┘      
    ┌─┛......║...........│└━━┓...┏┓.........╚═╴..╶═┭━┘┃.................│ ┃.......│ ┃........┏┘       
    ┃....┏━━━┦...........│   ┃...│┃......┏━┓.......│  ┃.................│ ┃.......│ ┃.......┏┘        
    ┃...┏┘   ┃...........│   ┃...│┃......│ ┃.......│  ┃.............╷...│ ┃.......│ ┃......┏┘         
    ┃...│    ┃...........│   └━━━┘└━━━━━━┘ ┃.......│┌─┶═══┭━━━━━┓...╵...│ ┃.......│ ┃......┟──────┐   
    ┃...│    └━━┓........┗────┐┌────────┐  ┃.......│┃.....│     ┃.......│ ┃.......│ ┃......║......│   
    ┃...│┌─────┐┃.............│┃........│  ┃.......│┃.....│    ┌┛...╷...│ ┃.......│ ┃......║......│   
    └┓.╶┵┧.....│┃.............│┃........│  ┃.......│┃.....│ ┌──┛....╚═══┵─┶┭┮═════┵─╋━━━━━━┦......│   
     ┃...║.....│┃......┏┓.....│┃...$....│  ┃.......│┃.....┗─┛..............│┃.......┗───┐  ┃......│   
     ┃...╵.....│┃......│┃.....│┃........│  ┃.......│╞╴.....................│┃...........│  ┃......│   
     ┃.........┗┛......┗┛.....│┃........│  ┃.......┗┛............┏━┓.......┗┛...........│  ┃......│   
     ┃...╷....................│┃........┗──┶══┭━┓..............┏━┘ ┃..............┏┓....┗──┛......│   
     ┃...║.....┏┓......┏┓.....│└━━━┓..........│ ┃....╷........┏┘   ┃.......┏┓.....│┃..............│   
     ┃...║.....┗┛......│┃.....│    ┃..........┗─┛....╵.......┏┘    ┃.......│┃.....│└━━━┓..........│   
     └━━━┦.............│┃.....│    ┃.........................│    ┌┛....┏━━┘┃.....│    ┃..........│   
         ┃.......┏━━━━━┘┃.....│    ┃.................╷.......│   ┌┛.....┗──┐└━━━━━┘    ┃..........│   
         ┃.......│      └━━━━━┘    ┃..............┏━━┦.......│   ┃...╷.....│           ┃..........│   
         ┃.......│                 ╞════╴.╶══╗...┏┘  ┃.......│   ┃...╵.....┗────────┐  ┃..........│   
         ┃.......│                 ┃.........║...┟───┛.......│   ┃..................│  ┃..........│   
         ┃.......┟──────┐ ┌───────┐┃.........┞━━━┦..........┏┼───┛...╷.....╷........┗──┧..........│   
   ┌─────┶┭━━━┓..╵......┗─┛.......│┃.........│   ┃..........│┃.....╶═╩┭━━━━┦...........┞━┮══╴.╶═┭━┘   
   ┃......│   └┓..................│┃.........│   ┃..........│┃....╷...│    ┃...........│ ┃......│     
   ┃......│    ╞╴.......┏━┓.......│└━━┓.┏━━━━┘   ┃..........│┃....╵...│    ┃...........│ ┃......│     
   ┃......┗────┛..╶┭━━━━┘ ┃.......│   ┃.│        ┃..........│┃........│    ┃...........│ ┃......│     
   ┃...............┗────┐ └━━━━━━━┘   ┃.│        ┃..........│┃....╷...│    ┃...........│ ┃......│     
   ┃....................│         ┌───┛.┗────────╋━━━━┓.┏━━━┼┶════╩┭━━┘    └━━━━━━┓....│ ┃......│     
   ┃....................│         ┃..............│    ┃.┗──┐┃......│ ┌───────┐    └┓...│ ╞═╴.╶┭━┘     
   ┃....................│         ┃..............│    ┃....┗┛......│ ┃.......│     ┃...│ ┃....│       
   ┃......╶┭━━━━━━┓.....┗───╥─────┛..............│┌───┶╴...........│ ┃.......│     ┃...│ ┃....│       
   └━┓.....│      ┃.........║............┏━┓.....┗┛........┏┓......┗─┛.......┗────┐┃...│ ┃....│       
     ┃.....┗┐     ┃.........║............│ └┓...........┏━━┘┃............┏┓.......│└━━━┘ ┃....│       
     ┃......┗──┐  ┃.........╵............│  ┃..........╶┵───┧......╷....┏┘┃.......│      ┃....│       
     └━━━━┓....│  ┃......................│  ┃...............║......┞┓...│ ┃.......┗┐     ┃....│       
      ┌───┶╴...│  └━━━━┓....╷............│  ┃...............║......│┃...│ └━┓......│     ┃....│       
      ┃........│       ┃....║............│  ┃...............╵......┗┶═┭━┘   ┃......│ ┌───┶╴..┏┘       
      ┃......┏━┘       └━━━━┦............│  ┃.......┏━┓...............│     ┃......│ ┃.......┗───┐    
   ┌──┛.....┏┘              ┃............│  ┃......┏┘ ┃...............│     ┃......│ ┃...........│    
   ┃........│               ┃............┗─┐┃......│  ┃...............│┌───┐┃......│ ┃...........│    
   ┃........│     ┌────┐    └━━━┓....╷.....│┃......│  ┃...............│┃...│└━━━━━━┘ ┃...........│    
   ┃........│     ┃....│        ┃....║.....│┃......│  ┃.....┏━━┓.....┏┘┃...┗────────┐┃..........┏┘    
   ┃........│     ┃....│  ┌─────┧....║.....│└━━━━━━┘  ┃.....│  ┃.....│ ┃............│└━┓.┏━━┓...│     
   ┃........┟─────┧....│  ┃.....╵....╵.....│       ┌──┛.....┗┐ ┃.....│ ┃............┗──┛.┗──┧...│     
   ┃........║.....║....┗┐ ┃................┟───────┛.........┗─┶═╴.╶═┵─┧....................╵...│     
   ┃...┏┮═══╝.....┞━━┓..┗┐┃.....╷....┏━━━━━┦...........................╵........................│     
   └━━━┘┃.........┟──┶╴..┗┛..┏━━┦....│     ┃................................................╷...│     
        ┃.........║....╷....┏┘  ┃....│     ┃........................................┏━━━━━━━┦...│     
        ┃.........╵....┞┓...│   └━━━━┘     ┃...........................╳............│       ┃...│     
    ┌───┛..............┟┛...│              ┃.................╷..........╶══┭━━┓.....│       ┃...│     
    ┃..................╵..┏━┘  ┌────────┐┌─┶═════╴...........║.............│  ┃.....│       └━━━┘     
    ┃.............╷......┏┘┌───┛........│┃...........┏━━━━━━━┦.............│  ╞═════┵───┐ ┌──────┐    
    ┃.............║.....┏┘ ┃............│┃...........│       ┃.............┟──┛.........│ ┃......│    
    ┃.............║....┏┘  ┃............│┃...........│ ┌─────┧.............║............│ ┃......│    
    ┃........┏━━━━┦....┗┐  ┃............│┃...........│ ┃.....║.............╵............│ ┃......│    
    ┃........│    ┃.....┗──┛............│┃...........│ ┃.....║..........................│ ┃......│    
    ┃....┏━━━┘    ┃...........┏┓........│┃...........│ ┃.....║.............╷............│ ┃......│    
    └━━━━┘   ┌────┶═══╗.......│┃........│┃........╷..┗┐┃.....║.............╚╴.╳.........┗─┛......│    
     ┌───┐┌──┛........║.......│└━━━━━━━━┘┃........┞┓..┗┛.....║..........┏┓.....┏━━━━━━┓..........│    
     ┃...│┃...........║.......│       ┌──┛........│└┓....┏━━━╨━━━━━━━━━━┘┃.....│   ┌──┛..........│    
     ┃...│┃...........╵.......┗───────┛......┏━━━━┘ ┃....┟───────┐       ┃.....│   ┃.............│    
     ┃...│┃..................╷...............│┌─────┛....║.......│       ┃.....┗─┐ ┃.............│    
     ┃...│┃..................║...............│┃........╳.╵.......│   ┌───┛..╷....│ ┃.......┏━━━━━┘    
     ┃...┟┛..................║...............│┃..................│   ┃.....┏╨┓...┗─┛.......┗┐         
     ┃...╵...................║...............│┃......╷...........│   ┃....┏┘ ┃..............│         
     └━┓....┏┓...............║...............│└━━━━━━┦....┏━┓.┏━━┘   ┃....│  ┃...┏━┓........│         
       └┓...│└━━━━━━━┓.......║...............│┌──────╋━━━━┘ ┃.│     ┌┛..┏┮┵──┛...│ ┃........│         
        ┃...│        ┃.......┞━┮═╴.┏━━━━━┮═══┵┧......│┌───╥─┛.┗──┐  ┃..┏┘┃....┏━━┘ ┃........┟───┐     
      ┌─┶═╴.┗───┐    └━━━━━━┮┵─┛...┟───┐ ┃....║......│┃...║......┗──┛.╶┵─┧....│    ┃........║...│     
      ┃.........│           ┃......║...│ ┃....║......│┃...║..............╵....┗────┧........║...│     
      ┃.........│           ┃......║...│ ┃....╵......│┃...║........................║........║...│     
      ┃.........│ ┌─────────┛......║...┗─┛...........┗┛...╚╴...┏┓........╷.........╠══╴..╶══╣...│     
      ┃.........│ ┃................╵..........╷..............╳.┗┶═══╗.┏━━┦.........║........║...│     
      ┃.........│ ┃...........................║......┏┓.............║.┗──┛.........║........╵...│     
      ┃.........│ ┃.............┏━━┓..........║......│┃.............║..............║............│     
      ┃.........│ ┃.............│  ┃..........╵......┟┛.............║.....┏━━┓.....║............│     
      └━━━━┓..╶═┵┐┃.............│  ┃......╷....┏━━━━━┦...╷..........║.....│  ┃.....║........┏━━━┘     
           └┓....│└━━━━━━━━━━━━━┘  └━━━━━━┦....┗─────┧...║..........┞┓....│  ┃.....║........│         
    ┌──────┐┃....│   ┌─────────┐    ┌────┐┃..........╵...║..........│┃....│  ┃.....║........┟────┐    
    ┃......│┃....│   ┃.........│    ┃....│┃....┏┓........┞┮══════┭━━┘┃....│  ┃.....╚══╴.....║....│    
    ┃......│╞╴.╶┭┘   ┃.........┗────┧....┟┛..┏━┘┃....╷...┗┧......│   ┃....│  └━━━━┓.........╵....│    
    ┃......│┃...│    ┃..............╵....╵..┏┘  ┃....╵....╵......│   ┃....│       ┃..............│    
    ┃......│┃...│    ┃.....................┏┘   ┃......┏┓........│┌──┶╴.╶═┵─┐     ┃.........╷....│    
    ┃......┗┧...│    ┃..............╷....┏━┘    ┃......│└┓.......│┃.........│┌───┐┃....┏━━━━┦....│    
    ┃.......╵...┗─┐  ┃...........┏━┮╝....┗────┐ ┃......│ └┓......│┃.........│┃...┟┶═╴.╶┵┐   ┃....│    
    ┃.............│  └━━━┓......┏┘ ┃..........│ ┃......│  ┃......│┃.........│┃...╵......│   ┃....│    
    ┃.............│      └┓.....│  ┃..........│ ┃......│  ┃......│┃.........│┃..........│   ┃....│    
    ┃.............│       ┃.....│  ┃..........│ └━━━━━━┘  ┃......│┃.........│┃...╷......│   └━━━━┘    
    ┃.............│       ┃.....│  └━━━━━━━━━━┘           ┃......│┃.........│└━━━╨━━━━━━┘             
    └━━━━━━━━━━━━━┘       └━━━━━┘                         └━━━━━━┘└━━━━━━━━━┘                         
                                                                                                      
                                                                                                      